4444444444444444444444444422222222222222222222222222222222222222222222222222222222222222222222222222
4444444444444444444444422222222222222222222222222222222222222222222222222222222222222222222222222222
4444444444444444444444444222222222222222222222222222222222222222222222222222222222222222222222222222
4444444444444444444444444222222222222222244444442444444222444442224444442444444424444442222222222222
4444444444444444444442222222222222222222222242222422222424222224242222222422222224222224222222222222
4444444444442222222222222222222222222222222242222422222424222224242222222422222224222224222222222222
4444442222222222222222222222222222222222222242222444444224444444242222222444422224444442222222222222
4442222222222222222222222222222222222222222242222422222424222224242222222422222224222224222222222222
2222222222222222222222222222222222222222222242222422222424222224242222222422222224222224222222222222
2222222222222222222222222222222222222222222242222422222424222224224444442444444424222224222222222222
2222222222222222222222222222222222222222222222222222222222222222222222222222222222222222222222222222
2222222222222222222222222222222222222222222222222222222222222222222222222222222222222222222222222222
2222222222222222222222222222222222222222222222222222222222222222222222222222222222222222222222222222
2222222222222222222222222222222222222222222222222222222222222222222222222222222222222222222222222222
2222222222222222222222222222222222222222222222222222222222222222222222222222222222222222222222222222
2222222222222222222222222222222222222222222222222222222222222222222222222222222222222222222222222222
2222222222222222222222222222222222222222222222222222222222222222222222222222222222222222222222222222
2222222222222222222222222222222222222222222222222222222222222222222222222222222222222222222222222222
2222222222222222222222222222222222222222222222222222222222222222222222222222222222222222222222222222
2222222222222222222222222222222222222222222222222222222222222222222222222222222222222222222222222222
2222222222222222222222222222222222222222222222222222222222222222222222222222222222222222222222222222
2222222222222222222222222222222222222222222222222222222222222222222222222222222222222222222222222222
2222222222222222222222222222222222222222222222222222222222222222222221111111111111111111111111112222
2222222222222222222222222222222222222222222222222222222222222222222221B1B1B1B1B1B1B1B1B1B1B1B1B12222
2222222222222222222222222222222222222222222222222222222222222222222221111111111111111111111111112222
2222222222222222222222222222222222222222222222222222222222222222222221B1B1B1B1B1B1B1B1B1B1B1B1B12222
2222222222222222222222222222222222222222222222222222222222222222222221111111111111111111111111112222
2222222222222222222222222222222222222222222222222222222222222222222221B1B1B1B1B1B1B1B1B1B1B1B1B12222
2222222222222222222222222222222222222222222222222222222222222222222221111111111111111111111111112222
2222222222222222222222222224242424242424242424242424242242242242242421B1B1B1B1B1B1B1B1B1B1B1B1B12222
2222222222222222222222222241111111111111111111111111111111111111111111111111111111111111111111112222
2222222222222222222222222221242424242424242424242424242424242424242421B1B1B1B1B1B1B1B1B1B1B1B1B12222
2222222222222222222222222241422222222222222222222222222222222222222221111111111111111111111111112222
2222222222222222222222222221222222222222222222222222222222222222222221B1B1B1B1B1B1B1B1B1B1B1B1B12222
2222222222222222222222222241422222222222222222222222222222222222222221111111111111111111111111112222
2222222222222222222222222221222222222222222222222222222222222222222221B1B1B1B1B1B1B1B1B1B1B1B1B12222
2222222222222222222222222241422222222222222222222222222222222222222221111111111111111111111111112222
2222222222222222222222222221222222222222222222222222222222222222222221B1B1B1B1B1B1B1B1B1B1B1B1B12222
2222222222222222222222222241422222222222222222222222222222222222222221111111111111111111111111112222
2222222222222222222222222221222222222222222222222222222222222222222222222222222222221222222222222222
2222222222222222222222222241422222222222222222222222222222222222222222222222222222221222222222222222
2222222222222222222222222221222222222222222222222222222222222222222222222222222222221222222222222222
2222222222222222222222222241422222222222222222222222222222222222222222222222222222221222222222222222
2222222222222222222222222221222222222222222222222222222222222222222222222222222222221222222222222222
2222222222222222222222222241422222222222222222222222222222222222222222222222222222221222222222222222
222222222222222222222222222122222222222222222222222A2A2A2A222222222222222222222222221222222222222222
2222222222222222222222222241422222222222222222222111111111122222222222222222222222221222222222222222
2222222222222222222222222221222222222222222222222134343434122222222222222222222222221222222222222222
2222222222222222222222222241422222222222222222222111111111122222222222222222222222221222222222222222
2222222222222222222222222221222222222222222222222222B212B2222222222222222222222222221222222222222222
2222222222222222222222222241422222222222222222222222241422222222222222222222222222221222222222222222
2222222222222222222222222221222222222222222222222222221222222222222222222222222222221222222222222222
2222222222222222222222222241422222222222222222222222241422222222222222222222222222221222222222222222
2222222222222222222222222221222222222222222222222222221222222222222222222222222222221222222222222222
2222222222222222222222222241422222222222222222222222241422222222222222222222222222221222222222222222
2222222222222222222222222221111111111111111111111111111111111111111111111111111111111222222222222222
2222222222222222222222222241422222222222222222222222222222222222222222222222222222221222222222222222
2222222222222222222222222221222222222222222444444444222222222224422222222222222222221222222222222222
2222222222222222222222222241422222222222444444444444444442222444444422222222222222221222222222222222
2222222222222222222222222221222222224444444444444444444444444444444444442222222222221222222222222222
2222222222222222222222222241422222444444444444444444444444444444444444444422222222221222222222222222
22222222222222222222222222212222222444444444444444442D2444444444444222422222222222221222222222222222
2222222222222222222222222241422222244444444444444422222224444444444444444222222222221222222222222222
2222222222222222222222222221222222224444444444444444222444444444444442222222222222221222222222222222
2222222222222222222222222241422222222224444444444422222224444444444422222222222222221222222222222222
2222222222222222222222222221222222222244444444444444424444444444444444442222222222221222222222222222
2222222222222222222222222241422222222222444444444444224444444442222244444442222222221222222222222222
2222222222222222222222222221222222222222244444444442244444444444444444444224222222221222222222222222
2222222222222222222222222241422222222222444444222222222444444444442224444444222222221222222222222222
2222222222222222222222222221222222222222222222222244444444422222444444444442222222221222222222222222
2222222222222222222222222241422222222224444444444444444444444444222244444444444442221222222222222222
2222222222222222222222222221222222222222222224444444444444444444444444444442222222221222222222222222
2222222222222222222222222241422222222222444444444444442222224444444444444444444422221222222222222222
2222222222222222222222222221222222222222222222244444444444444444444444422222222222221222222222222222
2222222222222222222222222241422222223222222444444444444444222222222222222222222222221222222222222222
2222222222222222222222222221222232222222222222222222222222222222222222222222222226221222222222222222
2222222222222222222222222241422522222222222222222222222222222222222222222224223222221222222222222222
2222222222222222222222222221222222224222222224222222222222222222252222222222222222221222222222222222
2222222222222222222222222241422222222222224222222222222222222222222222224222226222221222222222222222
2222222222222222222222222221222224222226222222224222222222223222222222222222222222221222222222222222
2222222222222222222222222241422222222222222223222222522222222222222225222226222242221222222222222222
2222222222222222222222222221222222222322252222232222222223222222232222222222222222221222222222222222
2424242422222222222222222281422224222222222222222222222222222222222222222522222422221222222222222222
1111111111111111111111111111222222222222222222222222222222222224223422222224222224221222222222222222
2424242418222222222222222221223222322222422222222222222222222222222222222222222222221222222222222222
2222222212222222222224222221223222522223222222242222232225222211141114111111111111111222222222222222
2322222212222222232222222321222226222225222222222222222322222A1A1A1A1A1A1A22252224222222223333333332
2222262215222222223222222221222222222255524222242222622522222214111411141225222222224224223333333332
2222222212222222222224222221222522222555552222522222222222222412222222221422222422222222223333333332
222232221222232224222222232122222222222522222222222522223262221222494222122262222622A224223333333332
2422222212242222222223222221822222222222223222242222222222224B1B422122211142222222221222223333333332
222222221222232225222222222111111111111111111111111111111111111111111111C111111111111111111111122222
2322222212222222222252223221222222222222222222222222422222224B1B422222211142222222222222222222222222
2222422212222232222222222221222222222222222222222222222222222211111111112222252222222222222222223222
2222222212222222222222C22221262222222222222222522222223224222224242424242222222222222422222222222222
2222222212232222223222122221222222222222232222222222222222222222222222222222222222222222222222222222
2222232212222242222222122221222222222222222323222223222262222522222222333222222222222222222232222322
2322222212222222222222182221222222322222222222222222222222222222223222333222224222222622222222222222
2222322211111111111111111111222222222522222422222222222242222252222222222222222222222222222225222222
4222222223222222242222224222225222222222222222222262222222222222222224222222222222222222222222222222